+-----------------------+
|+---------------------+|
||                     ||
||                     ||
||        @@@          ||
||      S@@@@          ||
||        @@           ||
||       @@@@@         ||
||        @ @@@@       ||
||           @@@       ||
||             T@      ||
||                     ||
||                     ||
|+---------------------+|
+-----------------------+
